18 18 18 18 18 18 18 18 18 18 18 18 18 18 18 18 18 18 18 18 18 18 18 18 18 18 18 18 18 18 18 18 18 18 18 18 18 18 44 18 18 18 18 18 18 18 18 18 18 18 18 18 18 18 18 18 18 18 18 18 18 18 18 18 18
18 18 18 18 18 18 18 18 18 18 44 18 18 18 18 18 18 18 18 18 18 18 18 18 18 18 18 18 18 18 18 18 18 18 18 18 18 18 18 44 18 18 18 18 18 18 18 18 18 18 18 18 18 18 18 18 18 18 18 18 18 18 18 18 18
18 18 44 18 18 18 18 18 18 18 18 18 18 18 18 18 18 18 18 18 18 18 18 18 18 18 44 18 18 18 18 18 18 44 18 18 18 18 18 18 18 18 18 18 18 18 18 18 18 18 44 18 18 18 18 18 18 18 18 18 18 18 18 44 18
18 18 18 18 18 18 18 18 18 18 18 18 18 18 18 18 44 18 18 18 18 18 18 18 18 18 18 18 18 18 44 18 18 18 18 18 18 18 18 18 18 44 18 18 18 18 18 44 18 18 18 18 18 18 18 18 18 18 18 18 18 18 18 18 18
18 18 18 18 18 18 18 18 18 18 18 18 18 18 18 18 18 18 18 18 18 18 18 18 18 18 18 18 18 18 18 18 18 18 18 18 18 18 18 18 18 18 18 18 18 18 18 18 18 18 18 18 18 18 18 18 18 18 18 18 18 18 18 18 18
18 18 18 18 18 18 18 18 23 21 21 21 21 21 21 21 21 21 21 21 21 21 21 21 21 21 21 21 21 21 21 21 21 21 21 21 21 21 21 21 21 21 21 21 21 21 21 21 21 21 21 21 21 21 21 21 24 18 18 18 18 18 44 18 18
18 18 18 18 18 18 18 18 19 10 10 10 10 10 10 10 10 10 12 10 10 10 10 10 10 12 10 10 10 10 10 10 10 10 10 12 10 10 10 10 10 10 10 10 10 10 12 10 10 10 10 10 10 10 10 10 17 18 18 18 18 18 18 18 18
18 18 44 18 18 18 18 18 19 10 12 13 13 13 13 13 13 13 13 13 13 13 13 13 13 13 13 13 13 13 13 13 13 13 13 13 13 10 43 43 10 13 13 13 13 13 13 13 13 13 13 13 13 13 10 10 17 18 18 18 18 18 18 18 18
18 18 18 18 18 18 18 18 19 10 10 13 37 39 38 37 39 37 37 39 38 37 37 39 37 37 37 37 37 37 37 37 37 37 38 37 13 10 43 43 10 13 37 39 37 39 37 37 39 37 39 37 38 13 12 10 17 18 18 18 18 18 18 18 18
18 18 18 18 18 18 18 18 19 10 10 13 37 38 37 13 13 13 13 13 13 13 13 13 13 13 13 13 13 13 13 13 13 13 13 38 13 13 13 13 13 13 38 39 38 39 37 38 39 37 39 37 38 13 10 10 17 18 18 44 18 18 18 18 18
18 18 18 18 18 18 18 18 19 10 10 13 37 37 38 13 37 38 37 37 37 37 37 38 37 37 37 37 37 38 37 38 37 37 13 38 37 39 37 39 37 38 37 39 37 39 37 37 39 37 39 37 38 13 10 10 17 18 18 18 18 18 18 18 18
18 18 18 18 18 44 18 18 19 10 10 13 37 37 37 13 37 37 37 13 37 37 38 37 38 37 37 37 38 37 38 37 38 37 13 38 37 39 37 39 37 38 38 39 38 39 37 39 39 37 39 37 38 13 10 10 17 18 18 18 18 18 18 18 18
18 18 18 18 18 18 18 18 19 10 10 13 37 39 37 13 38 37 37 13 37 37 13 13 13 13 13 13 13 13 13 13 13 13 13 37 37 39 37 39 37 38 37 39 37 39 37 38 38 37 39 37 38 13 10 10 17 18 18 18 18 44 18 18 18
18 18 18 44 18 18 18 18 19 10 43 13 37 37 39 13 37 37 39 13 39 37 39 37 38 37 39 37 39 37 39 37 38 37 13 37 13 13 13 13 13 13 38 39 38 39 37 38 39 37 39 37 38 13 10 10 17 18 18 18 18 18 18 18 18
18 18 18 18 18 18 18 18 19 10 43 13 37 37 37 13 38 39 37 13 37 38 37 37 37 38 37 37 37 39 37 38 37 37 13 39 13 43 43 10 10 13 37 39 37 39 37 37 38 37 39 37 38 13 10 10 17 18 18 18 18 18 18 18 18
18 18 18 18 18 18 18 18 19 10 43 13 37 39 37 13 37 39 37 13 38 37 37 13 13 13 13 13 13 13 13 13 13 13 13 37 13 43 43 11 10 13 38 39 38 39 39 37 37 38 39 37 38 13 10 10 17 18 18 18 18 18 18 18 18
18 18 18 18 18 18 18 18 19 10 10 13 13 13 37 13 39 37 38 13 37 37 37 13 37 37 37 38 37 37 39 37 37 13 13 13 13 43 10 10 10 13 37 39 37 39 37 37 39 37 39 37 38 13 12 10 17 18 18 18 18 18 18 18 18
18 18 18 18 18 18 18 18 19 10 10 13 39 13 37 13 13 13 13 13 37 38 38 13 37 13 13 13 13 37 37 37 38 13 38 37 13 43 10 10 11 13 38 39 38 39 37 39 39 37 39 37 38 13 10 10 17 18 18 18 18 18 44 18 18
18 18 18 18 18 18 18 18 19 10 10 13 37 13 37 39 38 37 38 13 38 37 38 13 38 13 37 37 13 38 37 38 37 13 37 37 13 12 10 10 10 13 38 39 38 39 37 38 39 37 39 37 38 13 10 10 17 18 18 18 44 18 18 18 18
18 18 44 18 18 18 18 18 19 12 10 13 37 13 37 13 13 13 38 13 37 37 37 13 37 13 38 37 13 37 38 37 38 13 37 37 13 10 10 11 10 13 37 39 37 39 37 37 39 38 39 37 38 13 10 10 17 18 18 18 18 18 18 18 18
18 18 18 18 18 18 18 18 19 10 10 13 37 13 37 13 39 13 37 13 37 37 37 13 37 13 37 37 13 37 37 37 37 13 37 37 13 10 10 10 10 13 38 39 38 39 37 38 39 37 39 37 38 13 10 10 17 18 18 44 18 18 18 18 18
18 18 18 18 18 18 18 18 19 10 10 13 37 13 37 13 37 13 37 13 37 39 37 13 37 13 38 37 39 37 39 37 38 37 39 39 13 10 10 10 10 13 37 39 37 39 37 38 38 37 39 37 38 13 10 10 17 18 18 18 18 18 18 18 18
18 18 18 18 18 18 18 18 19 10 10 13 37 13 39 13 37 13 37 13 38 37 38 13 37 13 38 38 39 39 39 39 37 37 37 37 13 10 10 10 10 13 13 13 13 13 13 13 10 13 13 13 13 13 10 10 17 18 18 18 18 18 18 18 18
18 18 18 18 18 18 18 18 19 10 10 13 37 13 13 13 39 13 37 13 37 37 37 37 37 13 37 37 37 37 38 37 38 37 37 37 13 10 12 10 11 10 10 10 12 10 10 10 10 10 10 11 10 10 10 10 17 18 18 18 18 18 18 18 18
18 18 18 18 18 18 18 18 19 10 10 13 38 37 38 13 37 13 37 13 39 37 39 13 39 13 37 38 37 39 37 38 37 37 38 37 13 10 10 10 10 10 10 10 10 10 36 34 34 34 40 10 10 10 10 10 17 18 18 18 18 18 18 18 18
18 18 18 18 18 18 18 18 19 10 43 13 37 39 39 13 37 13 37 13 37 37 39 13 37 13 38 37 37 38 39 37 38 37 37 37 13 10 10 43 43 10 10 10 43 10 32 31 31 31 30 10 43 10 10 10 17 18 18 18 18 18 18 18 18
18 18 18 44 18 18 18 18 19 10 12 13 13 13 39 13 37 13 38 13 13 13 13 13 39 13 13 13 13 13 13 13 13 13 13 13 13 10 10 43 43 10 12 10 10 12 32 31 31 31 30 10 10 12 11 10 17 18 18 18 44 44 18 18 18
18 18 18 18 18 18 18 18 19 10 10 13 37 13 39 13 37 37 37 37 37 37 37 37 37 38 37 38 37 37 37 38 37 37 37 38 13 10 10 12 10 10 10 10 10 10 41 29 31 27 42 10 10 11 10 10 17 18 18 18 18 18 18 18 18
18 18 18 18 18 18 18 18 19 10 10 13 38 13 38 13 13 13 13 13 13 13 13 13 13 13 13 13 13 13 13 13 13 37 13 13 13 10 10 10 10 10 10 11 12 10 10 32 31 30 10 10 43 10 10 10 17 18 18 18 18 18 18 18 18
18 18 18 18 18 18 18 18 19 10 10 13 37 13 37 38 37 39 38 39 37 37 39 37 37 37 37 37 38 37 38 37 37 38 13 37 13 10 10 43 43 43 10 10 10 10 10 32 31 30 10 10 11 43 43 10 17 18 18 18 18 18 18 18 18
18 18 18 18 18 18 18 18 19 10 10 13 39 13 39 13 13 13 13 37 13 13 13 13 13 13 13 13 13 13 37 13 38 39 13 37 13 10 10 43 43 43 10 10 10 43 10 32 31 30 10 11 10 43 43 10 17 18 18 18 18 18 18 18 18
18 18 18 18 18 18 18 18 19 12 10 13 37 13 38 13 37 37 13 37 13 37 38 37 38 37 37 37 37 13 37 13 37 37 13 37 13 10 10 43 10 12 10 10 10 11 10 32 31 30 10 10 10 11 10 10 17 18 44 44 18 18 18 18 18
18 18 18 18 18 18 18 18 19 10 10 13 39 13 37 13 37 37 13 38 13 37 37 37 37 38 38 37 38 13 38 13 37 37 13 37 13 10 10 10 10 10 10 10 10 10 10 32 31 30 10 10 10 10 11 10 17 18 18 18 18 18 18 18 18
18 18 18 18 18 18 18 18 19 10 10 13 37 13 38 13 37 37 13 38 13 37 37 37 37 37 37 37 37 13 37 13 38 38 13 37 13 43 43 10 10 10 10 12 10 10 10 32 31 30 10 10 11 10 10 10 17 18 18 18 18 18 18 44 44
18 18 18 18 18 18 18 18 19 10 10 13 37 13 37 13 39 38 13 37 13 39 38 37 37 37 37 37 37 13 37 13 37 38 13 38 13 43 43 10 10 10 10 10 10 10 10 32 31 30 10 10 10 10 10 10 17 18 18 18 18 18 18 18 18
18 18 18 18 44 18 18 18 19 10 10 13 37 13 37 13 13 13 13 37 13 13 13 13 13 13 13 13 13 13 38 13 13 13 13 38 13 10 10 10 10 10 10 10 11 10 10 32 31 30 10 11 10 10 12 10 17 18 18 44 18 18 18 18 18
18 18 18 18 18 18 18 18 19 10 10 13 37 13 38 37 37 37 37 37 37 38 37 37 37 37 37 37 37 37 37 39 38 37 13 37 13 10 10 10 10 10 10 10 10 10 10 32 31 30 10 10 10 10 10 10 17 18 18 18 18 18 18 18 18
18 18 18 18 18 18 18 18 19 10 10 13 38 13 13 13 13 13 13 13 13 13 13 13 13 13 13 13 37 13 37 13 38 37 13 37 13 10 10 10 10 10 10 10 10 10 10 32 31 30 10 10 11 12 10 10 17 18 18 18 18 18 18 18 18
18 18 18 18 18 18 18 18 19 10 10 13 37 39 38 37 37 37 37 37 37 37 13 37 37 39 37 13 37 13 38 13 37 37 13 37 13 10 10 10 10 10 10 10 10 10 10 32 31 30 10 10 10 10 10 10 17 18 18 18 18 18 18 18 18
18 18 18 18 18 18 18 18 19 10 10 13 38 13 13 13 37 13 13 13 13 37 13 37 13 13 13 13 38 13 37 13 37 37 13 37 13 10 10 10 43 10 10 11 10 10 10 32 31 30 10 43 12 10 10 10 17 18 18 18 18 18 18 18 18
18 18 18 18 18 44 18 18 19 10 12 13 37 13 39 13 39 13 38 38 13 37 13 39 13 13 13 13 38 13 37 13 37 37 13 37 13 10 10 10 10 10 11 10 10 10 10 32 31 30 10 10 10 10 11 10 17 18 18 18 18 18 18 18 18
18 18 18 18 18 18 18 18 19 10 10 13 37 13 37 13 37 13 37 37 13 38 13 37 38 37 37 38 37 13 39 13 37 39 37 37 13 10 10 10 10 10 10 10 10 10 10 32 31 30 10 10 43 10 10 10 17 18 18 18 18 18 18 18 18
18 18 18 18 18 18 18 18 19 10 10 13 37 13 39 13 39 13 37 37 13 39 13 13 13 13 13 13 13 13 39 13 13 13 13 13 13 43 10 43 10 10 10 10 10 43 10 32 31 30 10 10 10 43 10 10 17 18 18 18 18 18 18 18 18
18 18 18 18 18 18 18 18 19 10 10 13 39 13 37 13 39 13 39 37 13 37 38 37 37 37 39 37 39 37 39 37 39 37 38 37 13 43 10 10 11 10 10 10 43 10 10 32 31 30 10 11 43 43 10 10 17 18 18 18 18 18 18 18 18
18 18 18 18 18 18 18 18 19 12 43 13 37 39 37 13 37 13 37 39 37 38 37 37 37 39 37 39 37 38 38 37 39 38 37 37 13 43 10 10 10 10 10 10 10 10 10 32 31 30 10 10 43 43 10 10 17 18 18 18 44 18 18 18 18
18 18 18 18 44 18 18 18 19 10 43 13 13 13 13 13 10 13 13 13 13 13 13 13 13 13 13 13 13 13 13 13 13 13 13 13 13 43 10 11 10 10 10 10 43 10 10 32 31 30 10 10 11 10 10 10 17 18 18 18 18 18 18 18 18
18 18 18 18 18 18 18 18 19 10 43 10 10 10 10 13 10 13 10 10 10 10 10 10 10 10 10 43 43 43 43 43 43 10 43 43 43 43 10 10 12 10 10 10 10 10 10 32 31 30 10 10 10 10 10 10 17 18 18 18 18 18 18 18 18
18 18 18 18 18 18 18 18 19 10 10 12 10 10 43 13 10 13 10 10 10 10 10 10 10 10 43 10 43 43 10 10 43 10 10 10 10 10 10 10 10 10 12 10 10 10 10 32 31 30 12 43 10 11 10 10 17 18 18 18 18 18 18 18 18
18 18 18 18 18 18 18 18 19 10 10 11 10 10 43 10 10 10 43 10 10 10 10 10 10 43 10 10 43 10 10 10 10 10 10 10 11 10 10 10 10 10 10 10 10 10 10 32 31 30 10 10 10 10 10 10 17 18 18 18 18 18 44 18 18
18 18 18 18 18 18 18 18 19 10 10 10 10 10 43 10 10 10 43 43 10 10 10 10 10 10 10 11 43 10 10 43 10 10 10 10 10 43 43 10 10 10 10 10 10 10 10 32 31 30 10 43 10 10 10 10 17 18 18 18 18 18 18 18 18
18 18 18 18 18 18 18 18 19 10 10 10 10 12 10 43 10 10 10 43 10 10 10 10 10 10 10 12 10 10 10 11 10 10 10 11 10 43 43 10 10 10 10 10 10 10 10 41 28 42 10 10 10 11 10 10 17 18 18 18 18 18 18 18 18
18 18 18 44 18 18 18 18 19 10 43 43 11 10 10 43 10 12 10 43 10 10 10 10 10 10 10 10 10 43 10 10 10 10 10 10 10 10 43 10 10 10 10 10 10 10 10 10 10 10 10 10 10 10 10 10 17 18 18 18 18 18 18 18 18
18 18 18 18 18 18 18 18 19 10 43 10 10 10 10 12 10 43 10 43 11 10 10 10 10 10 12 10 10 10 10 11 10 10 11 10 10 10 43 43 10 10 10 11 10 10 10 10 10 10 10 10 10 10 10 10 17 18 18 18 18 18 18 18 18
18 18 18 18 18 18 18 18 19 10 10 10 43 10 11 10 10 10 10 43 10 10 10 14 15 15 15 15 15 15 15 15 15 15 16 10 10 10 10 10 10 10 10 10 10 10 10 10 10 10 10 10 10 10 11 10 17 18 18 18 44 18 18 18 18
18 18 18 18 18 18 18 18 19 10 10 10 43 43 10 10 43 12 10 43 43 12 10 17 18 18 18 18 18 18 18 18 18 18 19 10 10 10 10 10 10 10 10 10 10 10 10 10 10 10 10 11 10 10 10 10 17 18 18 18 18 18 18 18 18
18 18 18 18 18 18 18 18 19 10 10 10 43 43 10 10 10 10 43 43 10 10 10 17 18 18 18 18 18 18 18 18 18 18 19 10 10 10 10 10 10 10 10 10 10 10 10 11 10 10 11 10 10 10 10 10 17 18 18 18 18 18 18 18 18
18 18 18 18 18 18 18 18 19 10 10 10 10 10 10 10 11 10 10 10 10 10 10 17 18 18 18 18 18 18 18 18 18 18 25 15 16 10 10 10 10 10 10 10 10 10 10 10 10 10 10 10 10 10 10 10 17 18 18 18 18 18 18 18 18
18 18 18 18 18 18 18 18 19 10 10 10 10 10 10 10 10 10 10 10 10 10 10 17 18 18 18 18 44 18 18 18 18 18 18 18 19 10 10 10 10 10 10 10 10 10 10 10 10 10 10 10 10 10 10 10 17 18 18 18 18 18 44 18 18
18 18 18 44 18 18 18 18 25 15 15 15 15 15 15 15 15 15 15 15 15 15 15 26 18 18 18 18 18 18 18 18 18 18 18 18 25 15 15 15 15 15 15 15 15 15 15 15 15 15 15 15 15 15 15 15 26 18 18 18 18 18 18 18 18
18 18 18 18 18 18 18 18 18 18 18 18 18 18 18 18 18 18 18 18 18 18 18 18 18 18 18 18 18 18 44 18 18 18 18 18 18 18 18 18 18 18 18 18 18 18 18 18 18 18 18 18 18 18 18 18 18 18 18 18 18 18 18 18 18
18 18 18 18 18 18 18 18 18 18 44 18 18 18 18 18 18 18 18 18 18 18 18 18 18 18 18 18 18 18 18 18 18 18 18 18 44 18 18 18 18 18 18 18 18 18 18 18 18 18 18 18 18 18 18 18 18 18 18 44 18 18 18 18 18
18 18 18 18 18 18 18 18 18 18 18 18 18 18 18 18 18 18 18 18 18 18 18 44 18 18 18 18 18 18 18 18 18 18 18 18 18 18 18 18 44 18 18 18 18 18 18 18 18 18 18 18 18 18 18 18 18 18 18 18 18 18 18 18 18
18 18 18 18 18 44 18 18 18 18 18 18 18 18 18 18 18 18 18 18 44 18 18 18 18 18 18 18 18 18 18 18 18 44 18 18 18 18 18 18 18 18 18 18 18 18 18 18 18 18 44 18 18 18 18 18 44 18 18 18 18 18 18 18 18
18 18 44 18 18 18 18 18 18 18 18 18 18 18 18 18 18 18 18 18 18 18 18 18 18 18 18 18 18 18 18 18 18 18 18 18 18 18 18 18 18 44 18 18 18 18 18 18 18 18 18 18 18 18 44 18 18 18 18 18 18 18 18 18 18
18 18 18 18 18 18 18 18 18 18 18 18 18 18 18 18 18 18 18 18 18 18 18 18 18 18 18 18 18 18 18 18 18 18 18 18 18 18 18 18 18 18 18 18 18 18 18 18 18 18 18 18 18 18 18 18 18 18 18 18 18 18 18 18 18
